19 11
17 5

19

1

# # # . . . . . . . . . . . . . # # #
# # . . . . . . . . . . . . . . . # # 
# . . # # . . . . . . . . . # # . . # 
. . . # # . . . . . . . . . # # . . . 
. . . . . . . . . . . . . . . . . . . 
. . . . . . . . . @ . . . . . . . Y . 
. . . . . . . . . . . . . . . . . . . 
. . . # # . . . . . . . . . # # . . . 
# . . # # . . . . . . . . . # # . . #
# # . . . . . . . . . . . . . . . # #
# # # . . . . . . . . . . . . . # # #
