7 7
24 8

1

-1

. . . . . . .
. # # # # # .
. # . . . # .
. # . G . # .
. # . . . # .
. # # # # # .
. . . . . . .
